01000100000010000000000000000000000000001010000000000000101000001010000010110000101000001110000011100000111000001111
01100000101000001000000000000100000000000000000001000100000010000000000001000100000001000000000000000000000000000000
10110000111000001010000010100000101000000010010010100100101000001010000011100000111000001110000010100000101100001010
00000000000001000000000001000000001000001010000010100000101000001010000010100000101000001011000010110000101000001011
00000000000100000000000000000000000000000000000000000000000000000000000000000000000000000000000000000000000000000000
10100000101000000010000000100000000000000000010000000000000000000001100000000000000000000001000000000000000010000000
10110000101100001111000011110000111100001110000011100000111000001110000011100000111000001110000011100000101000001010
11110000111000001110000010100000101000001010000011100000111000001110000010100000101000001011000010110000101100001011
00000000010000000000000001000000000001000000000000000000000000000000000010000000101000000010000010100000101000001010
11100000111000001111000010100000001001001010000000000000000000000000000000000000000000000000000000000000000000000000
10110000101100001110000011100000101100001010000010100000101000001010000010100000101000001010000010100000101000001011
00000000000000000000000000000000000000000000000000000000101000001010000010100000101000001010000010100000101000001010
00000000000001000000000000011000000001000100000000000000000000000000000000000000000000000000000000000000000000000000
11100000111000001010000010100000101000000010000000100000000000000100000000000000000001000000100000000000000000000000
10100000111100001111000010110000101100001011000011110000101100001011000010110000101100001011000010100000111000001110
00000000101000001010000010100000111100001111000010100000101000001010000010100000111000001110000011100000111000001010
00000000000000000000000000000000000000000000000000000000000000000000000000000000000000000000000000000000010000000100
10100000101001001010000010110000101000001110000011100000101000000010000010100000000000000000000000000000000000000000
10100000101000001010000010100000101100001011000011100000111000001010000010100000101000001010000010100000101000001010
00000000000000000000000000000000000000000000000000000000000000000000000000000000010000001010000010100000101000001010
00000000000000000000000000000100010000000000000000001000000000000000000000000000000000000000000000000000000000000000
10110000101100001010000011100000111000001010000010100000001000000001000001100100000000000000000000000000000000000000
11110000111100001111000011110000111100001111000011110000111100001111000011100000111000001110000010110000101100001011
00000000010000000001000001000000000000001000000010100100101000001010010010100000111000001110000011100000101000001111
00000000000000000000000000000000000000000000000000000000000000000000000000000000000000000000000000000000000000000000
10100000101000001010000010100000101000001110000010110000101000001110000011100000101001001010000010010000010000000000
10100100101000001010000010100000101000001010000010100000101001001010000010100000111000001110000010100000101000001010
00000000000000000000000000000000000000000000000000000000000000000000000000000000000000000000000000000000000000000000
00000100000100000000000000000000000000000000000000000000000100000000000001000000000000000000000000000000000000000000
11100000111000001010000010110000101000001010000010100000111000001010000010100000011000000000000000000000000000000000
11100000101000001010000010110000111100001111000011110000111100001111000011110000111100001110000011100000111000001110
00000000000000000000000000000000000000000000000000000000000000000000000000000000101000000000000001100000101000001010
10100000100100000000000000000000000000000000000000000000000000000000000000000000000000000000000000000000000000000000
11100000101000001110000011100000101000001011000010110000111000001110000011100000101000001010000010100000101000001010
00000000000000000000000000000000000000000010000010100000101000001010010010100000101000001010000010100000101000001110
00000000000100000000000000000000000000000000000000000000000000000000000000000000000000000000000000000000000000000000
10100000000100000001000000000000000000000000000001000000000000000000000000000000000000000000000000000000000000000000
11100000111000001111000011110000111000001110000011100000111000001010000010100000101000001010000010100000000000001010
10010000100000000000000001010000101000001010000010100000101100001011000010100000101100001111000011110000111100001111
00000000000000000000000000000000000000000000000000000000000000000000000000000000000000000000000000010000000000000000
10100000101000001010000000000000100000001000000000000000000000000000000000000000000000000000000000000000000000000000
10100000101000001010000010100000111100001111000011100000111000001010000010110000101100001011000011110000111000001110
00000000000000000000000000000000000000000000000000000000000000000000000001100000101000001010000010100000101000001010
00000000000000000000000000000000000000000000000000000000000000000000000000000000000000000000000000000000000000000000
10100000101000000000000000000000000000000000010000000000000000000000000000000000000000000000000000000000000100000001
10110000101100001111000011110000111100001110000010110000101100001010000010100000101000001010000010100000011000001010
00000000000000000000000000000000000000000000000010000000100100001000000000000000101000001010000010100000101001001010
00000000000000000000000000000000000000000000000000000000000000000000000000000000000000000000000000000000000000000000
10110000101100001111000011100000101000001010000010100100000000000100000000000000000000000000000000000000000000000000
10100000101000001010000010100000101001001010000010100000101000001111000011110000111000001110000010110000101100001011
00000000000000000000000000000000000000000000000000000000000000000000000000000000000000000000000000000000000000000001
00000000000000000000000000000000000000000000000000000000000000000000010000000100000000000000000000000000000000000000
00100000000000000000000010100000000000000000000001000000000000000000000000010000000100000000000000000000000000000000
01000000101000001001000010100000101000001010000010100000101000001010000010100000101001001010000010100000101000001010
00000000000000000000000000000000000000000000000000000000000000000000000000000000000001000000000010000000100100000100
00000000000000000000000000000000000000000000000000000000000000000000000000000000000000000000000000000000000000000000
10110000101100001010000010100000101000001010000010110000101000001010000010100100101000000100010000000000000001000000
00000000000000000000000010000100101000001010000010000000101000001010010010100000101000001010000011100000101000001010
00000000000000000000000000000000000000000000000000000000000000000000000000000000000000000000000000000000000000000000
00000000000000000000000000000000000000000000000000000000000000000000000000000000000000000000000000010000000100000000
00000000000000001010000010100000101000001010000000000000000000000000000000000000000000000000000000000000000000000000
00000000000000000000000010000000101000001010000010100000101000001010000000000000000000000000000000000000000000000000
00000000000000000000000000000000000000000000000000000000000000000000000000000000000000000000000000000000000001000000
10000000000000000000000000000000000000000000000000000000000000000000000000000000000000000000000000000000000000000000
10100000101000001110000010100000101000001011000010100000111000001110000010100000101000001010000000000000101000001010
00000000000000000000000000000000000000000000000000000000000000000000000000000000000000000000000010100000101000000000
00000000000000000000010000000000000000000000000000000000000000000000000000000000000000000000000000000000000000000000
00000000000000000000000000000000000000000000000000000000000000000000000000000000000000000000000000000000000000000000
10100000101000001010000010100100000000000100000000000000000000000100000001000000000000000000000000000000000000000000
00000000000000000000000000000000000000000000000000000000000000000000000000000000000000000000000000000000100100001010
00000000000000000000000000000000000000000000000000000000000000000000000000000000000000000000000000000000000000000000
01000000000000000000000000000000000001000000000000000000000000000000000000000000000000000000000000000000000000000000
00000100101000001010000010000000101000000110000010100000101000001010000010100000111000001010000010100000101000001010
00000000000000000000000000000000000000000000000000000000000000000000000000000000000000000000000000000000000001000101
00000000000000000000000000000000000001000000000000000000000000000000000000000000000000000000000000000000000000000000
00000000000000000000000000000000000000000000000000000000000000000000000000000000000000000000000000000000000000000000
00000000000000000000010000000000010000000000000000000000000100000000000000000000000001000000000001010000000000000000
00000000000000000000000000000000000000000000000000000000000000000000000000000000000000000000000000000000000000000000
00000000000000000000000000000000000000000000000000000000000000000000000000000000000000000000000000000000000000000000
10100000101000000000000010100000100000000000000000000000000000000100000000000000000000000000000000000000000000000000
00000000000000000000000000010000000000000000000000010100000001000100000000000000000000001001000010000000101000001000
00000000000000000000000000000000000000000000000000000000000000000000000000000000000000000000000000000000000000000000
00000000000000000000000000000000000000000000000000000000000000000000000000000000000000000000000000000000000000000000
00000000000000000000000000000000000000000000000000000000000000000000000000000000000000000000000000000000000000000000
00000000000000000000000000000000000000000000000000000000000000000000000000000000000000000000000000000000000000000000
00000000000000000000000000000000000000000000000000000000000000000000000000000000000000000000000000000000000000000000
00000000000000000000000000000000000000000000000000000000000000000000000000000000000000000000000000000000000000000000
10100000101000001010000010100000101000001000000000000000000000000000000000000000000000000000000000000000000000000000
00000000000000000000000000000000000000000000000000000000000000000000000000000000000000000000000000000000000000000000
00000000000000000000000000000000000000000000000000000000000000000000000000000000000000000000000000000000000000000000
00000000000000000000000000000000000000000000000000000000000000000000000000000000000000000000000000000000000000000000
00000000000000000000000000000000000000000000000000000000000000000000000000000000000000000000000000000000000000000000
00000000000000000000000000000000000000000000000000000000000000000000000000000000000000000000000000000000000000000000
00000000000000000000000000000000000000000000000000000000000000000000000000000000000000000000000000000000000000000000
00000000000000000000000000000000000000000000000000000000000000000000000000000000000000000000000000000000000000000000
00000000000000000000000000010000000000000000000000000000000000000000000000000000000000000000000000000000000000000000
00000000000000000000000000000000000000000000000000000000000000000000000000000000000000000000000000000000000000000000
00000000000000000000000000000000000000000000000000000000000000000000000000000000000000000000000000000000000000000000
00000000000000000000000000000000000000000000000000000000000000000000000000000000000000000000000000000000000000000000
00000000000000000000000000000000000000000000000000000000000000000000000000000000000000000000000000000000000000000000
00000000000000000000000000000000000000000000000000000000000000000000000000000000000000000000000000000000000000000000
00000000000000000000000000000000000000000000000000000000000000000000000000000000000000000000000000000000000000000000
00000000000000000000000000000000000000000000000000000000000000000000000000000000000000000000000000000000000000000000
00000000000000000000000000000000000000000000000000000000000000000000000000000000000000000000000000000000000000000000
00000000000000000000000000000000000000000000000000000000000000000000000000000000000000000000000000000000000000000000
00000000000000000000000000000000000000000000000000000000000000000000000000000000000000000000000000000000000000000000
00000000000000000000000000000000000000000000000000000000000000000000000000000000000000000000000000000000000000000000
00000000000000000000000000000000000000000000000000000000000000000000000000000000000000000000000000000000000000000000
00000000000000000000000000000000000000000000000000000000000000000000000000000000000000000000000000000000000000000000
00000000000000000000000000000000000000000000000000000000000000000000000000000000000000000000000000000000000000000000
00000000000000000000000000000000000000000000000000000000000000000000000000000000000000000000000000000000000000000000
00000000000000000000000000000000000000000000000000000000000000000000000000000000000000000000000000000000000000000000
00000000000000000000000000000000000000000000000000000000000000000000000000000000000000000000000000000000000000000000
